"","year","STATENAME","DISTRICT","dem_ads","gop_ads","total_ads","dem_ad_share","gop_ad_share"
"1",2006,"Alabama","1",85,213,298,0.285234899328859,0.714765100671141
"2",2006,"Alabama","7",59,0,59,1,0
"3",2006,"Arizona","1",496,952,1448,0.342541436464088,0.657458563535912
"4",2006,"Arizona","5",2897,3480,6377,0.454288850556688,0.545711149443312
"5",2006,"Arizona","7",53,0,53,1,0
"6",2006,"Arizona","8",4043,2518,6561,0.616217040085353,0.383782959914647
"7",2006,"Arkansas","2",65,59,124,0.524193548387097,0.475806451612903
"8",2006,"California","11",1259,1519,2778,0.453203743700504,0.546796256299496
"9",2006,"California","19",50,70,120,0.416666666666667,0.583333333333333
"10",2006,"California","3",41,0,41,1,0
"11",2006,"California","4",404,144,548,0.737226277372263,0.262773722627737
"12",2006,"California","47",24,0,24,1,0
"13",2006,"California","5",200,0,200,1,0
"14",2006,"California","50",5499,6275,11774,0.46704603363343,0.53295396636657
"15",2006,"California","51",1383,0,1383,1,0
"16",2006,"California","6",5,0,5,1,0
"17",2006,"Colorado","3",1720,358,2078,0.82771896053898,0.17228103946102
"18",2006,"Colorado","4",2290,3170,5460,0.419413919413919,0.580586080586081
"19",2006,"Colorado","5",558,2174,2732,0.204245973645681,0.795754026354319
"20",2006,"Colorado","7",4274,2549,6823,0.626410669793346,0.373589330206654
"21",2006,"Connecticut","2",3027,4223,7250,0.41751724137931,0.58248275862069
"22",2006,"Connecticut","4",818,663,1481,0.552329507089804,0.447670492910196
"23",2006,"Connecticut","5",4365,5225,9590,0.455161626694473,0.544838373305527
"24",2006,"Florida","11",1020,0,1020,1,0
"25",2006,"Florida","13",2668,6524,9192,0.290252393385553,0.709747606614447
"26",2006,"Florida","16",3269,3697,6966,0.469279356876256,0.530720643123744
"27",2006,"Florida","22",6605,6307,12912,0.511539653035936,0.488460346964064
"28",2006,"Florida","8",409,1031,1440,0.284027777777778,0.715972222222222
"29",2006,"Florida","9",734,1116,1850,0.396756756756757,0.603243243243243
"30",2006,"Georgia","12",3620,3249,6869,0.527005386519144,0.472994613480856
"31",2006,"Georgia","13",74,0,74,1,0
"32",2006,"Georgia","4",99,0,99,1,0
"33",2006,"Hawaii","2",2402,476,2878,0.834607366226546,0.165392633773454
"34",2006,"Idaho","1",811,1617,2428,0.334019769357496,0.665980230642504
"35",2006,"Illinois","10",326,420,746,0.436997319034853,0.563002680965147
"36",2006,"Illinois","17",483,202,685,0.705109489051095,0.294890510948905
"37",2006,"Illinois","19",83,0,83,1,0
"38",2006,"Illinois","6",2154,2127,4281,0.503153468815697,0.496846531184303
"39",2006,"Illinois","8",1419,2931,4350,0.326206896551724,0.673793103448276
"40",2006,"Indiana","2",5972,7346,13318,0.448415678029734,0.551584321970266
"41",2006,"Indiana","3",662,141,803,0.824408468244085,0.175591531755915
"42",2006,"Indiana","4",14,0,14,1,0
"43",2006,"Indiana","7",257,21,278,0.924460431654676,0.0755395683453237
"44",2006,"Indiana","8",4631,3353,7984,0.580035070140281,0.419964929859719
"45",2006,"Indiana","9",6399,7843,14242,0.449304872911108,0.550695127088892
"46",2006,"Iowa","1",6549,8680,15229,0.430034802022457,0.569965197977543
"47",2006,"Iowa","2",61,63,124,0.491935483870968,0.508064516129032
"48",2006,"Iowa","3",3361,4973,8334,0.403287736981042,0.596712263018959
"49",2006,"Iowa","4",117,400,517,0.226305609284333,0.773694390715667
"50",2006,"Kansas","1",341,158,499,0.683366733466934,0.316633266533066
"51",2006,"Kansas","2",160,168,328,0.48780487804878,0.51219512195122
"52",2006,"Kansas","3",778,0,778,1,0
"53",2006,"Kentucky","1",90,978,1068,0.0842696629213483,0.915730337078652
"54",2006,"Kentucky","2",1698,2437,4135,0.410640870616687,0.589359129383313
"55",2006,"Kentucky","3",3055,3497,6552,0.466269841269841,0.533730158730159
"56",2006,"Kentucky","4",5308,7531,12839,0.413427837058961,0.586572162941039
"57",2006,"Louisiana","1",13,933,946,0.0137420718816068,0.986257928118393
"58",2006,"Louisiana","2",926,0,926,1,0
"59",2006,"Louisiana","3",2965,897,3862,0.767736923873641,0.232263076126359
"60",2006,"Maine","1",10,188,198,0.0505050505050505,0.94949494949495
"61",2006,"Maine","2",413,0,413,1,0
"62",2006,"Maryland","3",2740,14,2754,0.994916485112564,0.00508351488743646
"63",2006,"Maryland","4",25,0,25,1,0
"64",2006,"Michigan","4",321,0,321,1,0
"65",2006,"Michigan","6",4,0,4,1,0
"66",2006,"Michigan","7",112,690,802,0.139650872817955,0.860349127182045
"67",2006,"Michigan","9",8,181,189,0.0423280423280423,0.957671957671958
"68",2006,"Minnesota","1",78,0,78,1,0
"69",2006,"Minnesota","2",80,725,805,0.0993788819875776,0.900621118012422
"70",2006,"Minnesota","5",295,0,295,1,0
"71",2006,"Minnesota","6",2963,3366,6329,0.468162426923685,0.531837573076315
"72",2006,"Mississippi","2",595,3,598,0.994983277591973,0.00501672240802676
"73",2006,"Missouri","1",20,0,20,1,0
"74",2006,"Missouri","4",94,0,94,1,0
"75",2006,"Missouri","8",48,289,337,0.142433234421365,0.857566765578635
"76",2006,"Nebraska","1",509,498,1007,0.505461767626614,0.494538232373386
"77",2006,"Nevada","1",242,0,242,1,0
"78",2006,"Nevada","3",2404,2729,5133,0.468342100136373,0.531657899863628
"79",2006,"New Hampshire","1",235,360,595,0.394957983193277,0.605042016806723
"80",2006,"New Hampshire","2",1110,809,1919,0.578426263679,0.421573736321001
"81",2006,"New Jersey","7",280,95,375,0.746666666666667,0.253333333333333
"82",2006,"New Mexico","1",7332,9944,17276,0.424403797175272,0.575596202824728
"83",2006,"New Mexico","2",396,546,942,0.420382165605096,0.579617834394904
"84",2006,"New York","19",16,0,16,1,0
"85",2006,"New York","20",4275,2851,7126,0.599915801291047,0.400084198708953
"86",2006,"New York","24",4648,5178,9826,0.473030734785264,0.526969265214736
"87",2006,"New York","25",2708,2270,4978,0.543993571715548,0.456006428284452
"88",2006,"New York","26",8811,1844,10655,0.826935710933834,0.173064289066166
"89",2006,"New York","29",1286,1494,2780,0.462589928057554,0.537410071942446
"90",2006,"New York","3",2,140,142,0.0140845070422535,0.985915492957746
"91",2006,"North Carolina","11",3938,4308,8246,0.47756487994179,0.52243512005821
"92",2006,"North Carolina","13",1073,612,1685,0.636795252225519,0.363204747774481
"93",2006,"North Carolina","2",181,0,181,1,0
"94",2006,"North Carolina","8",582,1697,2279,0.255375164545853,0.744624835454147
"95",2006,"Ohio","1",2969,3156,6125,0.484734693877551,0.515265306122449
"96",2006,"Ohio","10",29,0,29,1,0
"97",2006,"Ohio","12",1394,1579,2973,0.468886646485032,0.531113353514968
"98",2006,"Ohio","13",1373,145,1518,0.904479578392622,0.0955204216073781
"99",2006,"Ohio","15",3937,4932,8869,0.443905739091217,0.556094260908783
"100",2006,"Ohio","18",2761,2590,5351,0.515978321809008,0.484021678190992
"101",2006,"Ohio","2",359,950,1309,0.274255156608098,0.725744843391902
"102",2006,"Ohio","3",115,485,600,0.191666666666667,0.808333333333333
"103",2006,"Ohio","5",27,423,450,0.06,0.94
"104",2006,"Ohio","6",2218,1085,3303,0.671510747805026,0.328489252194974
"105",2006,"Ohio","7",1117,0,1117,1,0
"106",2006,"Oklahoma","5",124,3547,3671,0.0337782620539363,0.966221737946064
"107",2006,"Oregon","3",38,0,38,1,0
"108",2006,"Oregon","5",2658,2799,5457,0.487080813633865,0.512919186366135
"109",2006,"Pennsylvania","10",4156,3587,7743,0.536742864522795,0.463257135477205
"110",2006,"Pennsylvania","11",160,6,166,0.963855421686747,0.036144578313253
"111",2006,"Pennsylvania","12",34,435,469,0.0724946695095949,0.927505330490405
"112",2006,"Pennsylvania","13",336,0,336,1,0
"113",2006,"Pennsylvania","16",94,64,158,0.594936708860759,0.40506329113924
"114",2006,"Pennsylvania","18",389,0,389,1,0
"115",2006,"Pennsylvania","3",12,186,198,0.0606060606060606,0.939393939393939
"116",2006,"Pennsylvania","4",1519,1615,3134,0.48468410976388,0.51531589023612
"117",2006,"Pennsylvania","6",1947,2450,4397,0.44280191039345,0.55719808960655
"118",2006,"Pennsylvania","7",1291,1611,2902,0.44486560992419,0.55513439007581
"119",2006,"Pennsylvania","8",1342,2582,3924,0.341997961264016,0.658002038735984
"120",2006,"Pennsylvania","9",27,0,27,1,0
"121",2006,"Rhode Island","1",676,0,676,1,0
"122",2006,"Rhode Island","2",571,0,571,1,0
"123",2006,"South Carolina","3",42,0,42,1,0
"124",2006,"South Carolina","4",29,0,29,1,0
"125",2006,"South Carolina","5",2289,2641,4930,0.464300202839757,0.535699797160243
"126",2006,"Tennessee","6",68,0,68,1,0
"127",2006,"Tennessee","9",1540,5,1545,0.996763754045307,0.00323624595469256
"128",2006,"Texas","16",19,0,19,1,0
"129",2006,"Texas","17",3049,2959,6008,0.507490013315579,0.492509986684421
"130",2006,"Texas","21",160,0,160,1,0
"131",2006,"Texas","22",901,724,1625,0.554461538461538,0.445538461538462
"132",2006,"Texas","23",121,417,538,0.224907063197026,0.775092936802974
"133",2006,"Texas","28",901,0,901,1,0
"134",2006,"Texas","31",93,288,381,0.244094488188976,0.755905511811024
"135",2006,"Utah","2",1083,558,1641,0.659963436928702,0.340036563071298
"136",2006,"Utah","3",40,7,47,0.851063829787234,0.148936170212766
"137",2006,"Vermont","1",3321,4727,8048,0.412649105367793,0.587350894632207
"138",2006,"Virginia","10",289,345,634,0.45583596214511,0.54416403785489
"139",2006,"Virginia","11",2,394,396,0.00505050505050505,0.994949494949495
"140",2006,"Virginia","2",5223,4777,10000,0.5223,0.4777
"141",2006,"Virginia","5",462,529,991,0.46619576185671,0.53380423814329
"142",2006,"Virginia","9",449,0,449,1,0
"143",2006,"Washington","2",462,0,462,1,0
"144",2006,"Washington","5",2452,2704,5156,0.475562451512801,0.524437548487199
"145",2006,"Washington","8",3914,2474,6388,0.612711333750783,0.387288666249217
"146",2006,"West Virginia","2",682,1921,2603,0.262005378409527,0.737994621590473
"147",2006,"Wisconsin","1",1,0,1,1,0
"148",2006,"Wisconsin","2",545,1102,1647,0.33090467516697,0.66909532483303
"149",2006,"Wisconsin","3",24,9,33,0.727272727272727,0.272727272727273
"150",2006,"Wisconsin","8",8524,7232,15756,0.541000253871541,0.458999746128459
"151",2010,"Alabama","2",5130,5204,10334,0.496419585833172,0.503580414166828
"152",2010,"Alabama","5",2590,2436,5026,0.515320334261838,0.484679665738162
"153",2010,"Alabama","7",2046,0,2046,1,0
"154",2010,"Alaska","1",311,1548,1859,0.167294244217321,0.832705755782679
"155",2010,"Arizona","1",1966,2146,4112,0.478112840466926,0.521887159533074
"156",2010,"Arizona","3",891,3178,4069,0.218972720570165,0.781027279429835
"157",2010,"Arizona","5",3835,2859,6694,0.572901105467583,0.427098894532417
"158",2010,"Arizona","7",2797,2389,5186,0.539336675665253,0.460663324334747
"159",2010,"Arizona","8",8134,4340,12474,0.652076318742985,0.347923681257015
"160",2010,"Arkansas","1",4019,2398,6417,0.626305127006389,0.373694872993611
"161",2010,"Arkansas","2",1956,1293,3249,0.602031394275162,0.397968605724838
"162",2010,"Arkansas","3",19,1059,1078,0.0176252319109462,0.982374768089054
"163",2010,"Arkansas","4",2228,166,2394,0.930659983291562,0.0693400167084378
"164",2010,"California","11",2657,806,3463,0.767253826162287,0.232746173837713
"165",2010,"California","17",250,72,322,0.77639751552795,0.22360248447205
"166",2010,"California","18",58,0,58,1,0
"167",2010,"California","20",4914,2507,7421,0.662174909041908,0.337825090958092
"168",2010,"California","23",493,448,941,0.523910733262487,0.476089266737513
"169",2010,"California","3",1910,725,2635,0.724857685009488,0.275142314990512
"170",2010,"California","45",3047,3435,6482,0.470070965751311,0.529929034248689
"171",2010,"California","47",69,0,69,1,0
"172",2010,"California","5",259,0,259,1,0
"173",2010,"California","51",537,265,802,0.669576059850374,0.330423940149626
"174",2010,"Colorado","3",4690,4028,8718,0.537967423721037,0.462032576278963
"175",2010,"Colorado","4",2976,2482,5458,0.545254672041041,0.454745327958959
"176",2010,"Colorado","6",21,20,41,0.51219512195122,0.48780487804878
"177",2010,"Colorado","7",2287,1453,3740,0.611497326203209,0.388502673796791
"178",2010,"Connecticut","1",262,47,309,0.84789644012945,0.15210355987055
"179",2010,"Connecticut","2",1114,141,1255,0.887649402390438,0.112350597609562
"180",2010,"Connecticut","4",336,257,593,0.566610455311973,0.433389544688027
"181",2010,"Connecticut","5",1739,1786,3525,0.493333333333333,0.506666666666667
"182",2010,"Delaware","1",729,0,729,1,0
"183",2010,"Florida","12",386,369,755,0.511258278145695,0.488741721854305
"184",2010,"Florida","14",58,0,58,1,0
"185",2010,"Florida","17",1179,0,1179,1,0
"186",2010,"Florida","19",497,39,536,0.927238805970149,0.0727611940298507
"187",2010,"Florida","2",12110,4581,16691,0.725540710562579,0.274459289437421
"188",2010,"Florida","22",4391,3545,7936,0.553301411290323,0.446698588709677
"189",2010,"Florida","24",1775,1520,3295,0.538694992412747,0.461305007587253
"190",2010,"Florida","25",1892,1509,3401,0.556306968538665,0.443693031461335
"191",2010,"Florida","8",2671,2399,5070,0.526824457593688,0.473175542406312
"192",2010,"Florida",NA,12,0,12,1,0
"193",2010,"Georgia","10",171,0,171,1,0
"194",2010,"Georgia","12",2947,563,3510,0.83960113960114,0.16039886039886
"195",2010,"Georgia","2",2535,1793,4328,0.585720887245841,0.414279112754159
"196",2010,"Georgia","8",5944,5657,11601,0.512369623308335,0.487630376691665
"197",2010,"Hawaii","1",7068,5527,12595,0.561175069472013,0.438824930527987
"198",2010,"Hawaii","2",989,0,989,1,0
"199",2010,"Idaho","1",5346,2314,7660,0.697911227154047,0.302088772845953
"200",2010,"Illinois","10",1682,722,2404,0.699667221297837,0.300332778702163
"201",2010,"Illinois","11",957,34,991,0.9656912209889,0.0343087790110999
"202",2010,"Illinois","14",2558,0,2558,1,0
"203",2010,"Illinois","17",5649,2997,8646,0.653365718251214,0.346634281748786
"204",2010,"Illinois","7",111,0,111,1,0
"205",2010,"Illinois","8",575,0,575,1,0
"206",2010,"Indiana","2",5485,4696,10181,0.538748649445045,0.461251350554955
"207",2010,"Indiana","3",2046,2147,4193,0.487956117338421,0.512043882661579
"208",2010,"Indiana","7",87,71,158,0.550632911392405,0.449367088607595
"209",2010,"Indiana","8",1781,3302,5083,0.350383631713555,0.649616368286445
"210",2010,"Indiana","9",5424,4016,9440,0.574576271186441,0.425423728813559
"211",2010,"Iowa","1",2005,2310,4315,0.464658169177289,0.535341830822711
"212",2010,"Iowa","2",3608,1677,5285,0.682686849574267,0.317313150425733
"213",2010,"Iowa","3",2190,1168,3358,0.652173913043478,0.347826086956522
"214",2010,"Kansas","1",9,5201,5210,0.00172744721689059,0.998272552783109
"215",2010,"Kansas","3",1007,1795,2802,0.359386152748037,0.640613847251963
"216",2010,"Kansas","4",3773,9533,13306,0.28355629039531,0.71644370960469
"217",2010,"Kentucky","3",875,492,1367,0.640087783467447,0.359912216532553
"218",2010,"Kentucky","6",5443,5482,10925,0.498215102974828,0.501784897025172
"219",2010,"Louisiana","1",7,0,7,1,0
"220",2010,"Louisiana","2",525,498,1023,0.513196480938416,0.486803519061584
"221",2010,"Louisiana","3",357,810,1167,0.305912596401028,0.694087403598972
"222",2010,"Louisiana","4",196,16,212,0.924528301886792,0.0754716981132075
"223",2010,"Maine","1",2493,787,3280,0.760060975609756,0.239939024390244
"224",2010,"Maine","2",1813,0,1813,1,0
"225",2010,"Maryland","1",6221,4538,10759,0.578213588623478,0.421786411376522
"226",2010,"Maryland","2",796,229,1025,0.776585365853659,0.223414634146341
"227",2010,"Massachusetts","1",586,18,604,0.970198675496689,0.0298013245033113
"228",2010,"Massachusetts","10",422,773,1195,0.353138075313808,0.646861924686192
"229",2010,"Massachusetts","2",471,0,471,1,0
"230",2010,"Massachusetts","3",492,0,492,1,0
"231",2010,"Massachusetts","4",1712,989,2701,0.633839318770826,0.366160681229174
"232",2010,"Massachusetts","5",457,0,457,1,0
"233",2010,"Massachusetts","6",557,44,601,0.926788685524126,0.0732113144758735
"234",2010,"Massachusetts","9",17,0,17,1,0
"235",2010,"Michigan","1",2139,4063,6202,0.344888745565946,0.655111254434053
"236",2010,"Michigan","13",47,0,47,1,0
"237",2010,"Michigan","15",760,224,984,0.772357723577236,0.227642276422764
"238",2010,"Michigan","3",1312,1426,2738,0.47918188458729,0.52081811541271
"239",2010,"Michigan","4",5,0,5,1,0
"240",2010,"Michigan","5",855,278,1133,0.754633715798764,0.245366284201236
"241",2010,"Michigan","7",10304,7573,17877,0.576383062035017,0.423616937964983
"242",2010,"Michigan","9",1818,801,2619,0.694158075601375,0.305841924398625
"243",2010,"Minnesota","1",1551,0,1551,1,0
"244",2010,"Minnesota","6",2925,2985,5910,0.49492385786802,0.50507614213198
"245",2010,"Minnesota","7",626,0,626,1,0
"246",2010,"Minnesota","8",250,257,507,0.493096646942801,0.506903353057199
"247",2010,"Mississippi","1",4064,3693,7757,0.523913884233595,0.476086115766405
"248",2010,"Mississippi","2",97,0,97,1,0
"249",2010,"Missouri","2",18,0,18,1,0
"250",2010,"Missouri","3",927,1307,2234,0.414950760966876,0.585049239033124
"251",2010,"Missouri","4",6763,5362,12125,0.557773195876289,0.442226804123711
"252",2010,"Missouri","7",262,2932,3194,0.0820288040075141,0.917971195992486
"253",2010,"Missouri","8",803,1814,2617,0.30683989300726,0.69316010699274
"254",2010,"Montana","1",415,288,703,0.590327169274538,0.409672830725462
"255",2010,"Nebraska","2",1349,2528,3877,0.347949445447511,0.652050554552489
"256",2010,"Nevada","3",5448,3772,9220,0.590889370932755,0.409110629067245
"257",2010,"New Hampshire","1",664,2493,3157,0.210326259106747,0.789673740893253
"258",2010,"New Hampshire","2",3457,1771,5228,0.661247130833971,0.338752869166029
"259",2010,"New Jersey","2",37,0,37,1,0
"260",2010,"New Jersey","3",980,243,1223,0.80130825838103,0.19869174161897
"261",2010,"New Mexico","1",4904,4395,9299,0.527368534250995,0.472631465749005
"262",2010,"New Mexico","2",3773,3184,6957,0.542331464711801,0.457668535288199
"263",2010,"New Mexico","3",372,51,423,0.879432624113475,0.120567375886525
"264",2010,"New York","1",67,83,150,0.446666666666667,0.553333333333333
"265",2010,"New York","13",33,0,33,1,0
"266",2010,"New York","14",80,0,80,1,0
"267",2010,"New York","19",146,112,258,0.565891472868217,0.434108527131783
"268",2010,"New York","20",7469,4226,11695,0.638648995297135,0.361351004702864
"269",2010,"New York","21",177,0,177,1,0
"270",2010,"New York","23",4873,6993,11866,0.410669138715658,0.589330861284342
"271",2010,"New York","24",6761,6114,12875,0.525126213592233,0.474873786407767
"272",2010,"New York","25",3874,1438,5312,0.729292168674699,0.270707831325301
"273",2010,"New York","27",415,139,554,0.749097472924188,0.250902527075812
"274",2010,"New York","29",354,1318,1672,0.211722488038278,0.788277511961722
"275",2010,"North Carolina","11",2089,2200,4289,0.487059920727442,0.512940079272558
"276",2010,"North Carolina","13",354,0,354,1,0
"277",2010,"North Carolina","2",1377,435,1812,0.759933774834437,0.240066225165563
"278",2010,"North Carolina","4",393,218,611,0.643207855973813,0.356792144026187
"279",2010,"North Carolina","7",746,0,746,1,0
"280",2010,"North Carolina","8",3105,2053,5158,0.601977510663048,0.398022489336952
"281",2010,"North Dakota","1",8798,8657,17455,0.50403895731882,0.49596104268118
"282",2010,"Ohio","1",1769,1765,3534,0.500565930956423,0.499434069043577
"283",2010,"Ohio","10",59,0,59,1,0
"284",2010,"Ohio","12",1185,1412,2597,0.456295725837505,0.543704274162495
"285",2010,"Ohio","13",2286,953,3239,0.705773386847793,0.294226613152207
"286",2010,"Ohio","15",1563,1874,3437,0.45475705557172,0.54524294442828
"287",2010,"Ohio","16",4204,3093,7297,0.576127175551597,0.423872824448403
"288",2010,"Ohio","18",3685,1762,5447,0.676519184872407,0.323480815127593
"289",2010,"Ohio","2",55,163,218,0.252293577981651,0.747706422018349
"290",2010,"Ohio","6",2445,1570,4015,0.608966376089664,0.391033623910336
"291",2010,"Ohio","8",189,0,189,1,0
"292",2010,"Ohio","9",1364,2988,4352,0.313419117647059,0.686580882352941
"293",2010,"Oklahoma","2",4131,157,4288,0.963386194029851,0.0366138059701493
"294",2010,"Oklahoma","5",803,3511,4314,0.186138154844692,0.813861845155308
"295",2010,"Oregon","1",664,574,1238,0.536348949919225,0.463651050080775
"296",2010,"Oregon","3",263,0,263,1,0
"297",2010,"Oregon","5",3061,3334,6395,0.478655199374511,0.521344800625489
"298",2010,"Pennsylvania","10",2690,1770,4460,0.603139013452915,0.396860986547085
"299",2010,"Pennsylvania","11",2365,1984,4349,0.543803173143251,0.456196826856749
"300",2010,"Pennsylvania","12",7340,7083,14423,0.508909380850031,0.491090619149969
"301",2010,"Pennsylvania","13",579,0,579,1,0
"302",2010,"Pennsylvania","15",564,346,910,0.61978021978022,0.38021978021978
"303",2010,"Pennsylvania","16",92,126,218,0.422018348623853,0.577981651376147
"304",2010,"Pennsylvania","17",2098,103,2201,0.953203089504771,0.0467969104952294
"305",2010,"Pennsylvania","18",124,0,124,1,0
"306",2010,"Pennsylvania","3",1868,1739,3607,0.517881896312725,0.482118103687275
"307",2010,"Pennsylvania","4",1665,1117,2782,0.598490294751977,0.401509705248023
"308",2010,"Pennsylvania","6",209,0,209,1,0
"309",2010,"Pennsylvania","7",939,1160,2099,0.447355883754169,0.552644116245831
"310",2010,"Pennsylvania","8",2977,653,3630,0.820110192837466,0.179889807162534
"311",2010,"Pennsylvania","9",7,0,7,1,0
"312",2010,"Rhode Island","1",3063,437,3500,0.875142857142857,0.124857142857143
"313",2010,"Rhode Island","2",363,25,388,0.935567010309278,0.0644329896907216
"314",2010,"South Carolina","1",23,2681,2704,0.00850591715976331,0.991494082840237
"315",2010,"South Carolina","2",4840,4048,8888,0.544554455445545,0.455445544554455
"316",2010,"South Carolina","3",39,3030,3069,0.0127077223851417,0.987292277614858
"317",2010,"South Carolina","5",6075,7005,13080,0.464449541284404,0.535550458715596
"318",2010,"South Carolina","6",266,0,266,1,0
"319",2010,"South Dakota","1",9568,8065,17633,0.542618953099302,0.457381046900698
"320",2010,"Tennessee","3",72,4140,4212,0.0170940170940171,0.982905982905983
"321",2010,"Tennessee","4",2344,3602,5946,0.394214598049109,0.605785401950891
"322",2010,"Tennessee","5",434,19,453,0.958057395143488,0.0419426048565121
"323",2010,"Tennessee","6",144,3108,3252,0.044280442804428,0.955719557195572
"324",2010,"Tennessee","8",1663,13368,15031,0.110638014769476,0.889361985230524
"325",2010,"Tennessee","9",168,202,370,0.454054054054054,0.545945945945946
"326",2010,"Texas","16",231,35,266,0.868421052631579,0.131578947368421
"327",2010,"Texas","17",4065,3361,7426,0.547401023431188,0.452598976568812
"328",2010,"Texas","18",10,0,10,1,0
"329",2010,"Texas","20",263,10,273,0.963369963369963,0.0366300366300366
"330",2010,"Texas","23",2341,1861,4202,0.5571156592099,0.4428843407901
"331",2010,"Texas","25",623,129,752,0.828457446808511,0.171542553191489
"332",2010,"Texas","26",1,0,1,1,0
"333",2010,"Texas","27",1065,459,1524,0.698818897637795,0.301181102362205
"334",2010,"Texas","28",74,0,74,1,0
"335",2010,"Utah","2",2049,128,2177,0.941203491042719,0.0587965089572807
"336",2010,"Virginia","11",1836,1632,3468,0.529411764705882,0.470588235294118
"337",2010,"Virginia","2",4777,4629,9406,0.507867318732724,0.492132681267276
"338",2010,"Virginia","5",12467,7711,20178,0.61785112498761,0.38214887501239
"339",2010,"Virginia","7",33,452,485,0.0680412371134021,0.931958762886598
"340",2010,"Virginia","9",5547,4261,9808,0.565558727569331,0.434441272430669
"341",2010,"Washington","2",1103,566,1669,0.66087477531456,0.33912522468544
"342",2010,"Washington","3",3256,3384,6640,0.490361445783133,0.509638554216867
"343",2010,"Washington","5",115,0,115,1,0
"344",2010,"Washington","8",2678,1334,4012,0.667497507477567,0.332502492522433
"345",2010,"Washington","9",59,0,59,1,0
"346",2010,"West Virginia","3",2427,4411,6838,0.354928341620357,0.645071658379643
"347",2010,"Wisconsin","3",361,3704,4065,0.0888068880688807,0.911193111931119
"348",2010,"Wisconsin","4",67,0,67,1,0
"349",2010,"Wisconsin","7",157,37,194,0.809278350515464,0.190721649484536
"350",2010,"Wisconsin","8",2941,3426,6367,0.461912988848751,0.538087011151249
"351",2012,"Alabama","02",22,515,537,0.0409683426443203,0.95903165735568
"352",2012,"Alabama","06",35,952,987,0.0354609929078014,0.964539007092199
"353",2012,"Arizona","01",4725,4211,8936,0.528760071620412,0.471239928379588
"354",2012,"Arizona","02",3683,3042,6725,0.547657992565056,0.452342007434944
"355",2012,"Arizona","03",14,0,14,1,0
"356",2012,"Arizona","08",5598,4576,10174,0.550226066443877,0.449773933556123
"357",2012,"Arizona","09",4098,3161,7259,0.564540570326491,0.435459429673509
"358",2012,"Arkansas","01",283,539,822,0.344282238442822,0.655717761557178
"359",2012,"Arkansas","02",120,232,352,0.340909090909091,0.659090909090909
"360",2012,"Arkansas","04",543,3090,3633,0.149463253509496,0.850536746490504
"361",2012,"California","03",805,572,1377,0.584604212055192,0.415395787944808
"362",2012,"California","06",174,0,174,1,0
"363",2012,"California","07",5071,3793,8864,0.572089350180505,0.427910649819495
"364",2012,"California","09",3449,3407,6856,0.50306301050175,0.49693698949825
"365",2012,"California","10",5040,3508,8548,0.589611605053814,0.410388394946186
"366",2012,"California","16",1047,398,1445,0.724567474048443,0.275432525951557
"367",2012,"California","20",327,0,327,1,0
"368",2012,"California","21",1544,3653,5197,0.297094477583221,0.702905522416779
"369",2012,"California","22",362,0,362,1,0
"370",2012,"California","24",8615,9838,18453,0.466861756895898,0.533138243104102
"371",2012,"California","26",343,1343,1686,0.20344009489917,0.79655990510083
"372",2012,"California","33",131,0,131,1,0
"373",2012,"California","35",942,0,942,1,0
"374",2012,"California","36",7415,5510,12925,0.573694390715667,0.426305609284333
"375",2012,"California","39",4,0,4,1,0
"376",2012,"California","52",7932,6634,14566,0.544555814911438,0.455444185088562
"377",2012,"Colorado","03",4644,4801,9445,0.491688724192695,0.508311275807306
"378",2012,"Colorado","04",69,0,69,1,0
"379",2012,"Colorado","06",3830,3822,7652,0.500522739153163,0.499477260846837
"380",2012,"Colorado","07",3078,4053,7131,0.431636516617585,0.568363483382415
"381",2012,"Connecticut","02",471,0,471,1,0
"382",2012,"Connecticut","05",5769,3458,9227,0.625230302373469,0.374769697626531
"383",2012,"Florida","02",4878,4140,9018,0.540918163672655,0.459081836327345
"384",2012,"Florida","09",1123,296,1419,0.791402396053559,0.208597603946441
"385",2012,"Florida","10",2818,780,3598,0.783212896053363,0.216787103946637
"386",2012,"Florida","13",134,150,284,0.471830985915493,0.528169014084507
"387",2012,"Florida","16",546,1230,1776,0.307432432432432,0.692567567567568
"388",2012,"Florida","18",4769,7656,12425,0.383822937625755,0.616177062374246
"389",2012,"Florida","19",18,2313,2331,0.00772200772200772,0.992277992277992
"390",2012,"Florida","22",2334,1050,3384,0.689716312056738,0.310283687943262
"391",2012,"Florida","23",127,88,215,0.590697674418605,0.409302325581395
"392",2012,"Florida","26",17,44,61,0.278688524590164,0.721311475409836
"393",2012,"Georgia","01",134,159,293,0.457337883959044,0.542662116040956
"394",2012,"Georgia","02",865,628,1493,0.579370395177495,0.420629604822505
"395",2012,"Georgia","12",15991,12353,28344,0.564175839683884,0.435824160316116
"396",2012,"Hawaii","01",800,1326,2126,0.376293508936971,0.623706491063029
"397",2012,"Hawaii","02",3382,0,3382,1,0
"398",2012,"Idaho","02",65,1591,1656,0.0392512077294686,0.960748792270531
"399",2012,"Illinois","02",332,0,332,1,0
"400",2012,"Illinois","08",2629,2168,4797,0.548050865124036,0.451949134875964
"401",2012,"Illinois","10",1874,3378,5252,0.356816450875857,0.643183549124143
"402",2012,"Illinois","11",2655,2741,5396,0.492031134173462,0.507968865826538
"403",2012,"Illinois","12",4372,4545,8917,0.490299428058764,0.509700571941236
"404",2012,"Illinois","13",5358,5342,10700,0.500747663551402,0.499252336448598
"405",2012,"Illinois","15",10,358,368,0.0271739130434783,0.972826086956522
"406",2012,"Illinois","17",7727,8706,16433,0.470212377533013,0.529787622466987
"407",2012,"Indiana","02",2992,3846,6838,0.437554840596666,0.562445159403334
"408",2012,"Indiana","07",429,0,429,1,0
"409",2012,"Indiana","08",3434,3803,7237,0.474506010777947,0.525493989222053
"410",2012,"Indiana","09",149,1329,1478,0.100811907983762,0.899188092016238
"411",2012,"Iowa","01",2386,2588,4974,0.479694410936872,0.520305589063128
"412",2012,"Iowa","02",3568,1513,5081,0.702223971659122,0.297776028340878
"413",2012,"Iowa","03",5346,5798,11144,0.479720028715004,0.520279971284996
"414",2012,"Iowa","04",4486,4298,8784,0.510701275045537,0.489298724954463
"415",2012,"Kentucky","03",118,0,118,1,0
"416",2012,"Kentucky","06",6258,5713,11971,0.522763344749812,0.477236655250188
"417",2012,"Louisiana","02",16,0,16,1,0
"418",2012,"Louisiana","03",598,4721,5319,0.112427147960143,0.887572852039857
"419",2012,"Louisiana",NA,5,0,5,1,0
"420",2012,"Maine","01",514,28,542,0.948339483394834,0.0516605166051661
"421",2012,"Maine","02",2251,1003,3254,0.691763982790412,0.308236017209588
"422",2012,"Maryland","02",268,20,288,0.930555555555556,0.0694444444444444
"423",2012,"Maryland","06",152,0,152,1,0
"424",2012,"Massachusetts","01",1307,0,1307,1,0
"425",2012,"Massachusetts","04",945,101,1046,0.903441682600382,0.0965583173996176
"426",2012,"Massachusetts","06",1339,1925,3264,0.410232843137255,0.589767156862745
"427",2012,"Michigan","03",2930,358,3288,0.891119221411192,0.108880778588808
"428",2012,"Michigan","05",186,138,324,0.574074074074074,0.425925925925926
"429",2012,"Michigan","06",562,2998,3560,0.157865168539326,0.842134831460674
"430",2012,"Michigan","11",201,408,609,0.330049261083744,0.669950738916256
"431",2012,"Michigan","13",55,0,55,1,0
"432",2012,"Michigan","14",379,0,379,1,0
"433",2012,"Minnesota","01",242,0,242,1,0
"434",2012,"Minnesota","02",731,616,1347,0.542687453600594,0.457312546399406
"435",2012,"Minnesota","03",13,832,845,0.0153846153846154,0.984615384615385
"436",2012,"Minnesota","06",1601,2440,4041,0.396189062113338,0.603810937886662
"437",2012,"Minnesota","07",652,137,789,0.826362484157161,0.173637515842839
"438",2012,"Minnesota","08",5579,3860,9439,0.591058374827842,0.408941625172158
"439",2012,"Mississippi","02",245,6,251,0.97609561752988,0.0239043824701195
"440",2012,"Missouri","01",43,0,43,1,0
"441",2012,"Missouri","02",48,551,599,0.0801335559265442,0.919866444073456
"442",2012,"Missouri","04",796,1400,2196,0.36247723132969,0.63752276867031
"443",2012,"Montana","01",4181,3041,7222,0.578925505400166,0.421074494599834
"444",2012,"Nebraska","02",728,1170,1898,0.383561643835616,0.616438356164384
"445",2012,"Nevada","01",141,0,141,1,0
"446",2012,"Nevada","03",4385,4052,8437,0.51973450278535,0.48026549721465
"447",2012,"Nevada","04",2828,4873,7701,0.367225035709648,0.632774964290352
"448",2012,"New Hampshire","01",1311,1400,2711,0.483585392843969,0.516414607156031
"449",2012,"New Hampshire","02",3250,1474,4724,0.687976291278578,0.312023708721423
"450",2012,"New Jersey","03",454,408,862,0.526682134570766,0.473317865429234
"451",2012,"New Jersey","09",143,18,161,0.888198757763975,0.111801242236025
"452",2012,"New Mexico","01",3271,460,3731,0.876708657196462,0.123291342803538
"453",2012,"New York","01",249,136,385,0.646753246753247,0.353246753246753
"454",2012,"New York","04",92,0,92,1,0
"455",2012,"New York","07",17,0,17,1,0
"456",2012,"New York","18",327,15,342,0.956140350877193,0.043859649122807
"457",2012,"New York","19",3870,5353,9223,0.419603165998048,0.580396834001952
"458",2012,"New York","20",252,4,256,0.984375,0.015625
"459",2012,"New York","21",7161,7944,15105,0.47408142999007,0.52591857000993
"460",2012,"New York","22",266,595,861,0.308943089430894,0.691056910569106
"461",2012,"New York","23",942,382,1324,0.711480362537764,0.288519637462236
"462",2012,"New York","24",5823,5708,11531,0.504986557974157,0.495013442025843
"463",2012,"New York","25",4586,4317,8903,0.515107267213299,0.484892732786701
"464",2012,"New York","26",21,300,321,0.0654205607476635,0.934579439252336
"465",2012,"New York","27",8279,4462,12741,0.649792010046307,0.350207989953693
"466",2012,"North Carolina","07",4546,3303,7849,0.579182061409097,0.420817938590903
"467",2012,"North Carolina","08",516,3625,4141,0.12460758270949,0.87539241729051
"468",2012,"North Carolina","09",497,2473,2970,0.167340067340067,0.832659932659933
"469",2012,"North Carolina","11",104,689,793,0.131147540983607,0.868852459016393
"470",2012,"North Dakota","01",849,2353,3202,0.265146783260462,0.734853216739538
"471",2012,"Ohio","03",639,0,639,1,0
"472",2012,"Ohio","05",353,879,1232,0.286525974025974,0.713474025974026
"473",2012,"Ohio","06",5385,4332,9717,0.554183389935165,0.445816610064835
"474",2012,"Ohio","07",435,330,765,0.568627450980392,0.431372549019608
"475",2012,"Ohio","09",1448,0,1448,1,0
"476",2012,"Ohio","10",450,355,805,0.559006211180124,0.440993788819876
"477",2012,"Ohio","13",3,0,3,1,0
"478",2012,"Ohio","16",3740,3702,7442,0.502553077129804,0.497446922870196
"479",2012,"Oklahoma","01",115,916,1031,0.111542192046557,0.888457807953443
"480",2012,"Oklahoma","02",4256,3199,7455,0.570892018779343,0.429107981220657
"481",2012,"Oklahoma","05",167,212,379,0.440633245382586,0.559366754617414
"482",2012,"Oregon","01",2712,1215,3927,0.690603514132926,0.309396485867074
"483",2012,"Oregon","05",647,0,647,1,0
"484",2012,"Pennsylvania","06",394,0,394,1,0
"485",2012,"Pennsylvania","10",60,246,306,0.196078431372549,0.803921568627451
"486",2012,"Pennsylvania","11",550,518,1068,0.51498127340824,0.48501872659176
"487",2012,"Pennsylvania","12",9067,6808,15875,0.571149606299213,0.428850393700787
"488",2012,"Pennsylvania","17",2533,0,2533,1,0
"489",2012,"Pennsylvania","18",510,1173,1683,0.303030303030303,0.696969696969697
"490",2012,"Rhode Island","01",3541,2367,5908,0.599356804333108,0.400643195666892
"491",2012,"Rhode Island","02",265,375,640,0.4140625,0.5859375
"492",2012,"South Dakota","01",3737,3111,6848,0.545706775700935,0.454293224299065
"493",2012,"Tennessee","03",145,6067,6212,0.0233419188667096,0.97665808113329
"494",2012,"Tennessee","04",1329,1741,3070,0.432899022801303,0.567100977198697
"495",2012,"Tennessee","09",311,1706,2017,0.154189390183441,0.845810609816559
"496",2012,"Texas","14",18,0,18,1,0
"497",2012,"Texas","15",1177,169,1346,0.87444279346211,0.12555720653789
"498",2012,"Texas","16",504,98,602,0.837209302325581,0.162790697674419
"499",2012,"Texas","23",5421,4088,9509,0.570091492270481,0.429908507729519
"500",2012,"Texas","27",541,419,960,0.563541666666667,0.436458333333333
"501",2012,"Texas","28",317,0,317,1,0
"502",2012,"Texas","30",18,0,18,1,0
"503",2012,"Texas","33",3105,0,3105,1,0
"504",2012,"Texas","34",786,79,865,0.908670520231214,0.0913294797687861
"505",2012,"Texas","35",724,0,724,1,0
"506",2012,"Utah","04",7305,6058,13363,0.54665868442715,0.45334131557285
"507",2012,"Virginia","02",2770,1940,4710,0.588110403397028,0.411889596602972
"508",2012,"Virginia","05",2015,1722,3737,0.539202568905539,0.460797431094461
"509",2012,"Virginia","07",282,1007,1289,0.21877424359969,0.78122575640031
"510",2012,"Virginia","09",549,293,842,0.652019002375297,0.347980997624703
"511",2012,"Washington","01",3814,0,3814,1,0
"512",2012,"Washington","05",580,1509,2089,0.277644806127334,0.722355193872666
"513",2012,"Washington","06",651,451,1102,0.590744101633394,0.409255898366606
"514",2012,"Washington","08",64,328,392,0.163265306122449,0.836734693877551
"515",2012,"Washington","09",158,0,158,1,0
"516",2012,"Washington","10",955,0,955,1,0
"517",2012,"West Virginia","03",2618,2033,4651,0.56288970113954,0.43711029886046
"518",2012,"Wisconsin","01",464,2067,2531,0.183326748320822,0.816673251679178
"519",2012,"Wisconsin","02",1605,0,1605,1,0
"520",2012,"Wisconsin","07",575,1755,2330,0.246781115879828,0.753218884120172
"521",2012,"Wisconsin","08",2467,2855,5322,0.463547538519354,0.536452461480646
"522",2014,"Alabama","6",183,242,425,0.430588235294118,0.569411764705882
"523",2014,"Arizona","1",9802,5601,15403,0.63636953840161,0.36363046159839
"524",2014,"Arizona","2",12107,10549,22656,0.534383827683616,0.465616172316384
"525",2014,"Arizona","9",3325,720,4045,0.822002472187886,0.177997527812114
"526",2014,"Arkansas","1",4,0,4,1,0
"527",2014,"Arkansas","2",3794,2104,5898,0.643268904713462,0.356731095286538
"528",2014,"Arkansas","4",1465,494,1959,0.747830525778458,0.252169474221542
"529",2014,"California","10",785,0,785,1,0
"530",2014,"California","16",532,0,532,1,0
"531",2014,"California","17",417,0,417,1,0
"532",2014,"California","20",200,0,200,1,0
"533",2014,"California","21",3067,6157,9224,0.332502168256722,0.667497831743278
"534",2014,"California","24",3068,166,3234,0.948670377241806,0.0513296227581942
"535",2014,"California","26",1845,0,1845,1,0
"536",2014,"California","3",126,0,126,1,0
"537",2014,"California","33",134,458,592,0.226351351351351,0.773648648648649
"538",2014,"California","36",6282,1030,7312,0.859135667396061,0.140864332603939
"539",2014,"California","52",9052,6217,15269,0.592835156198834,0.407164843801166
"540",2014,"California","6",24,0,24,1,0
"541",2014,"California","7",6781,7034,13815,0.490843286283026,0.509156713716974
"542",2014,"California","9",314,0,314,1,0
"543",2014,"Colorado","5",899,0,899,1,0
"544",2014,"Colorado","6",6258,4376,10634,0.588489749858943,0.411510250141057
"545",2014,"Connecticut","5",3518,944,4462,0.788435679067683,0.211564320932317
"546",2014,"Florida","13",4672,3558,8230,0.56767922235723,0.43232077764277
"547",2014,"Florida","18",3629,681,4310,0.84199535962877,0.15800464037123
"548",2014,"Florida","19",19,12,31,0.612903225806452,0.387096774193548
"549",2014,"Florida","2",12249,10484,22733,0.538820217305239,0.461179782694761
"550",2014,"Florida","22",404,0,404,1,0
"551",2014,"Florida","26",5386,3468,8854,0.608312627061215,0.391687372938785
"552",2014,"Florida","9",110,0,110,1,0
"553",2014,"Georgia","12",18475,11278,29753,0.620945786979464,0.379054213020536
"554",2014,"Georgia","4",189,0,189,1,0
"555",2014,"Hawaii","1",2146,1905,4051,0.52974574179215,0.47025425820785
"556",2014,"Idaho","2",162,156,318,0.509433962264151,0.490566037735849
"557",2014,"Illinois","10",3950,2953,6903,0.57221497899464,0.42778502100536
"558",2014,"Illinois","11",460,0,460,1,0
"559",2014,"Illinois","12",8733,5571,14304,0.610528523489933,0.389471476510067
"560",2014,"Illinois","13",3664,3166,6830,0.536456808199122,0.463543191800878
"561",2014,"Illinois","17",8288,683,8971,0.923865789767027,0.0761342102329729
"562",2014,"Illinois","2",12,0,12,1,0
"563",2014,"Illinois","8",258,0,258,1,0
"564",2014,"Indiana","2",1159,2199,3358,0.34514592019059,0.65485407980941
"565",2014,"Iowa","1",2228,1674,3902,0.570989236289082,0.429010763710917
"566",2014,"Iowa","2",2723,1925,4648,0.585843373493976,0.414156626506024
"567",2014,"Iowa","3",8116,4456,12572,0.645561565383392,0.354438434616608
"568",2014,"Iowa","4",3752,1103,4855,0.772811534500515,0.227188465499485
"569",2014,"Kansas","3",366,696,1062,0.344632768361582,0.655367231638418
"570",2014,"Kentucky","2",74,0,74,1,0
"571",2014,"Kentucky","3",301,207,508,0.59251968503937,0.40748031496063
"572",2014,"Kentucky","6",902,2053,2955,0.305245346869712,0.694754653130288
"573",2014,"Louisiana","2",45,0,45,1,0
"574",2014,"Maine","1",249,0,249,1,0
"575",2014,"Maine","2",5442,3845,9287,0.58598040271347,0.41401959728653
"576",2014,"Maryland","1",423,0,423,1,0
"577",2014,"Maryland","6",245,0,245,1,0
"578",2014,"Massachusetts","6",1350,873,2223,0.607287449392713,0.392712550607287
"579",2014,"Massachusetts","9",112,55,167,0.67065868263473,0.329341317365269
"580",2014,"Michigan","11",128,695,823,0.155528554070474,0.844471445929526
"581",2014,"Michigan","14",14,0,14,1,0
"582",2014,"Michigan","3",71,0,71,1,0
"583",2014,"Michigan","6",3128,2942,6070,0.515321252059308,0.484678747940692
"584",2014,"Michigan","7",1921,1956,3877,0.495486200670622,0.504513799329378
"585",2014,"Michigan","8",779,268,1047,0.744030563514804,0.255969436485196
"586",2014,"Minnesota","2",369,1392,1761,0.20954003407155,0.79045996592845
"587",2014,"Minnesota","7",5938,4288,10226,0.580676706434578,0.419323293565421
"588",2014,"Minnesota","8",7708,4960,12668,0.608462267129776,0.391537732870224
"589",2014,"Mississippi","3",8,0,8,1,0
"590",2014,"Missouri","8",56,32,88,0.636363636363636,0.363636363636364
"591",2014,"Montana","1",6534,4806,11340,0.576190476190476,0.423809523809524
"592",2014,"Nebraska","2",3553,2894,6447,0.55110904296572,0.44889095703428
"593",2014,"Nevada","1",341,29,370,0.921621621621622,0.0783783783783784
"594",2014,"Nevada","3",413,1844,2257,0.182986264953478,0.817013735046522
"595",2014,"Nevada","4",1173,756,1929,0.608087091757387,0.391912908242613
"596",2014,"New Hampshire","1",1462,2184,3646,0.4009873834339,0.5990126165661
"597",2014,"New Hampshire","2",3573,853,4426,0.807275192046995,0.192724807953005
"598",2014,"New Jersey","1",1129,0,1129,1,0
"599",2014,"New Jersey","3",464,2138,2602,0.178324365872406,0.821675634127594
"600",2014,"New Mexico","1",1085,98,1183,0.917159763313609,0.0828402366863905
"601",2014,"New Mexico","2",2182,2889,5071,0.43028988365214,0.56971011634786
"602",2014,"New York","1",291,69,360,0.808333333333333,0.191666666666667
"603",2014,"New York","11",854,0,854,1,0
"604",2014,"New York","18",668,572,1240,0.538709677419355,0.461290322580645
"605",2014,"New York","19",3503,4169,7672,0.456595411887383,0.543404588112617
"606",2014,"New York","20",201,124,325,0.618461538461539,0.381538461538462
"607",2014,"New York","21",4598,3108,7706,0.596677913314301,0.403322086685699
"608",2014,"New York","23",3859,1994,5853,0.659320006834102,0.340679993165898
"609",2014,"New York","24",7890,4127,12017,0.656569859365898,0.343430140634102
"610",2014,"New York","25",380,653,1033,0.367860600193611,0.632139399806389
"611",2014,"New York","4",192,0,192,1,0
"612",2014,"North Carolina","11",1,0,1,1,0
"613",2014,"North Carolina","13",21,197,218,0.0963302752293578,0.903669724770642
"614",2014,"North Carolina","2",595,0,595,1,0
"615",2014,"North Carolina","6",565,559,1124,0.502669039145907,0.497330960854093
"616",2014,"North Dakota","1",1237,1132,2369,0.522161249472351,0.477838750527649
"617",2014,"Ohio","1",34,105,139,0.244604316546763,0.755395683453237
"618",2014,"Ohio","14",238,299,537,0.443202979515829,0.556797020484171
"619",2014,"Ohio","6",866,1674,2540,0.340944881889764,0.659055118110236
"620",2014,"Oklahoma","5",88,802,890,0.098876404494382,0.901123595505618
"621",2014,"Oregon","3",436,0,436,1,0
"622",2014,"Oregon","5",527,0,527,1,0
"623",2014,"Pennsylvania","10",62,228,290,0.213793103448276,0.786206896551724
"624",2014,"Pennsylvania","12",91,622,713,0.127629733520337,0.872370266479663
"625",2014,"Pennsylvania","16",6,220,226,0.0265486725663717,0.973451327433628
"626",2014,"Pennsylvania","17",151,0,151,1,0
"627",2014,"Pennsylvania","5",7,0,7,1,0
"628",2014,"Pennsylvania","6",264,279,543,0.486187845303867,0.513812154696133
"629",2014,"Rhode Island","1",606,0,606,1,0
"630",2014,"Tennessee","3",167,0,167,1,0
"631",2014,"Tennessee","4",1007,248,1255,0.802390438247012,0.197609561752988
"632",2014,"Texas","15",95,63,158,0.60126582278481,0.39873417721519
"633",2014,"Texas","23",6561,2849,9410,0.697236981934113,0.302763018065887
"634",2014,"Texas","27",175,483,658,0.265957446808511,0.734042553191489
"635",2014,"Texas","29",29,0,29,1,0
"636",2014,"Utah","1",31,0,31,1,0
"637",2014,"Utah","4",648,918,1566,0.413793103448276,0.586206896551724
"638",2014,"Virginia","10",3655,1576,5231,0.698719174154081,0.301280825845919
"639",2014,"Virginia","2",1429,925,2354,0.607051826677995,0.392948173322005
"640",2014,"Virginia","7",410,528,938,0.437100213219616,0.562899786780384
"641",2014,"Washington","1",726,0,726,1,0
"642",2014,"Washington","5",174,500,674,0.258160237388724,0.741839762611276
"643",2014,"Washington","6",250,0,250,1,0
"644",2014,"Washington","9",162,0,162,1,0
"645",2014,"West Virginia","2",3059,1833,4892,0.625306623058054,0.374693376941946
"646",2014,"West Virginia","3",14265,8425,22690,0.628691053327457,0.371308946672543
"647",2014,"Wisconsin","6",311,715,1026,0.303118908382066,0.696881091617934
"648",2014,"Wisconsin","8",249,219,468,0.532051282051282,0.467948717948718
"649",2016,"Alabama","6",59,126,185,0.318918918918919,0.681081081081081
"650",2016,"Alaska","1",3942,723,4665,0.845016077170418,0.154983922829582
"651",2016,"Arizona","1",5525,643,6168,0.895752269779507,0.104247730220493
"652",2016,"Arizona","2",2136,5607,7743,0.275862068965517,0.724137931034483
"653",2016,"Arizona","9",1817,0,1817,1,0
"654",2016,"Arkansas","2",121,376,497,0.243460764587525,0.756539235412475
"655",2016,"California","10",5024,3494,8518,0.589809814510448,0.410190185489552
"656",2016,"California","16",977,45,1022,0.955968688845401,0.0440313111545988
"657",2016,"California","17",1712,0,1712,1,0
"658",2016,"California","20",770,922,1692,0.455082742316785,0.544917257683215
"659",2016,"California","21",4665,6333,10998,0.424168030551009,0.575831969448991
"660",2016,"California","24",5556,5828,11384,0.48805340829234,0.51194659170766
"661",2016,"California","25",1174,101,1275,0.92078431372549,0.0792156862745098
"662",2016,"California","3",67,0,67,1,0
"663",2016,"California","36",4021,69,4090,0.983129584352078,0.0168704156479218
"664",2016,"California","49",7734,3672,11406,0.678064176749079,0.321935823250921
"665",2016,"California","52",2247,1007,3254,0.690534726490473,0.309465273509527
"666",2016,"California","6",45,0,45,1,0
"667",2016,"California","7",4167,3559,7726,0.539347657261196,0.460652342738804
"668",2016,"Colorado","2",200,0,200,1,0
"669",2016,"Colorado","3",3376,3824,7200,0.468888888888889,0.531111111111111
"670",2016,"Colorado","5",64,0,64,1,0
"671",2016,"Colorado","6",5661,4608,10269,0.551270815074496,0.448729184925504
"672",2016,"Connecticut","5",598,0,598,1,0
"673",2016,"Delaware","1",32,0,32,1,0
"674",2016,"Florida","1",6,0,6,1,0
"675",2016,"Florida","13",2696,58,2754,0.978939724037763,0.0210602759622367
"676",2016,"Florida","18",5346,6285,11631,0.459633737425845,0.540366262574155
"677",2016,"Florida","26",4191,4078,8269,0.506832748820897,0.493167251179103
"678",2016,"Florida","27",334,547,881,0.379114642451759,0.620885357548241
"679",2016,"Florida","3",382,177,559,0.683363148479428,0.316636851520572
"680",2016,"Florida","7",3264,1757,5021,0.650069707229636,0.349930292770364
"681",2016,"Hawaii","1",132,0,132,1,0
"682",2016,"Idaho","1",708,474,1182,0.598984771573604,0.401015228426396
"683",2016,"Illinois","10",3963,3220,7183,0.551719337324238,0.448280662675762
"684",2016,"Illinois","12",1026,1028,2054,0.499513145082765,0.500486854917235
"685",2016,"Illinois","17",1365,0,1365,1,0
"686",2016,"Illinois","8",511,0,511,1,0
"687",2016,"Indiana","2",1352,2396,3748,0.360725720384205,0.639274279615795
"688",2016,"Indiana","7",314,0,314,1,0
"689",2016,"Indiana","9",3909,5072,8981,0.435252199086961,0.564747800913039
"690",2016,"Iowa","1",5817,4896,10713,0.542985158218986,0.457014841781014
"691",2016,"Iowa","3",5265,5843,11108,0.473982715160245,0.526017284839755
"692",2016,"Kansas","3",2459,2668,5127,0.479617710161888,0.520382289838112
"693",2016,"Kansas","4",63,647,710,0.0887323943661972,0.911267605633803
"694",2016,"Kentucky","6",397,2032,2429,0.16344174557431,0.83655825442569
"695",2016,"Louisiana","2",336,0,336,1,0
"696",2016,"Louisiana","4",109,3080,3189,0.0341799937284415,0.965820006271559
"697",2016,"Maine","2",15943,10958,26901,0.592654548158061,0.407345451841939
"698",2016,"Maryland","2",381,0,381,1,0
"699",2016,"Maryland","6",498,401,899,0.553948832035595,0.446051167964405
"700",2016,"Michigan","11",121,633,754,0.160477453580902,0.839522546419098
"701",2016,"Michigan","6",1532,2162,3694,0.414726583649161,0.585273416350839
"702",2016,"Michigan","7",5571,3369,8940,0.623154362416107,0.376845637583893
"703",2016,"Michigan","8",1999,1603,3602,0.554969461410328,0.445030538589672
"704",2016,"Minnesota","2",5775,2173,7948,0.726597886260695,0.273402113739306
"705",2016,"Minnesota","3",5455,3728,9183,0.594032451268649,0.405967548731351
"706",2016,"Minnesota","8",10645,6259,16904,0.629732607666824,0.370267392333176
"707",2016,"Missouri","7",1,0,1,1,0
"708",2016,"Montana","1",12044,10772,22816,0.527875175315568,0.472124824684432
"709",2016,"Nebraska","2",6785,5613,12398,0.547265688014196,0.452734311985804
"710",2016,"Nevada","1",254,0,254,1,0
"711",2016,"Nevada","2",193,0,193,1,0
"712",2016,"Nevada","3",5226,4579,9805,0.53299337072922,0.46700662927078
"713",2016,"Nevada","4",4215,3906,8121,0.519024750646472,0.480975249353528
"714",2016,"New Hampshire","1",629,887,1516,0.41490765171504,0.58509234828496
"715",2016,"New Hampshire","2",1007,11,1018,0.989194499017682,0.0108055009823183
"716",2016,"New Jersey","5",1267,554,1821,0.695771554091159,0.304228445908841
"717",2016,"New Mexico","1",1147,0,1147,1,0
"718",2016,"New Mexico","2",13,0,13,1,0
"719",2016,"New Mexico","3",1039,0,1039,1,0
"720",2016,"New York","1",178,0,178,1,0
"721",2016,"New York","19",6668,6346,13014,0.51237129245428,0.48762870754572
"722",2016,"New York","20",160,0,160,1,0
"723",2016,"New York","21",2832,2725,5557,0.509627496850819,0.490372503149181
"724",2016,"New York","22",12496,3031,15527,0.804791653249179,0.195208346750821
"725",2016,"New York","23",3104,2352,5456,0.56891495601173,0.43108504398827
"726",2016,"New York","24",6836,5967,12803,0.533937358431618,0.466062641568382
"727",2016,"New York","25",2088,642,2730,0.764835164835165,0.235164835164835
"728",2016,"New York","27",81,0,81,1,0
"729",2016,"New York","3",15,33,48,0.3125,0.6875
"730",2016,"North Carolina","8",39,268,307,0.127035830618893,0.872964169381108
"731",2016,"North Dakota","1",40,521,561,0.071301247771836,0.928698752228164
"732",2016,"Ohio","1",30,209,239,0.125523012552301,0.874476987447699
"733",2016,"Oregon","5",845,50,895,0.94413407821229,0.0558659217877095
"734",2016,"Pennsylvania","11",100,131,231,0.432900432900433,0.567099567099567
"735",2016,"Pennsylvania","16",1548,880,2428,0.637561779242175,0.362438220757825
"736",2016,"Pennsylvania","8",5292,2746,8038,0.65837272953471,0.34162727046529
"737",2016,"Rhode Island","2",587,0,587,1,0
"738",2016,"South Carolina","5",530,321,851,0.622796709753232,0.377203290246769
"739",2016,"South Dakota","1",155,0,155,1,0
"740",2016,"Tennessee","9",27,0,27,1,0
"741",2016,"Texas","1",8,0,8,1,0
"742",2016,"Texas","18",2,0,2,1,0
"743",2016,"Texas","23",9370,5875,15245,0.61462774680223,0.38537225319777
"744",2016,"Texas","27",70,0,70,1,0
"745",2016,"Utah","1",471,0,471,1,0
"746",2016,"Utah","2",5,308,313,0.0159744408945687,0.984025559105431
"747",2016,"Utah","4",3282,3471,6753,0.486006219458019,0.513993780541981
"748",2016,"Virginia","10",5231,3895,9126,0.573197457812842,0.426802542187158
"749",2016,"Virginia","5",4342,2979,7321,0.593088375904931,0.406911624095069
"750",2016,"Virginia","7",101,37,138,0.731884057971015,0.268115942028986
"751",2016,"Washington","5",133,335,468,0.284188034188034,0.715811965811966
"752",2016,"Washington","7",1895,0,1895,1,0
"753",2016,"West Virginia","2",69,628,697,0.0989956958393113,0.901004304160689
"754",2016,"Wisconsin","8",3397,4393,7790,0.43607188703466,0.56392811296534
"755",2016,NA,"1",24,0,24,1,0
"756",2018,"Alabama","2",754,0,754,1,0
"757",2018,"Alabama","5",412,324,736,0.559782608695652,0.440217391304348
"758",2018,"Arizona","1",3445,33,3478,0.990511788384129,0.00948821161587119
"759",2018,"Arizona","2",6015,2652,8667,0.694011768778124,0.305988231221876
"760",2018,"Arizona","4",10,0,10,1,0
"761",2018,"Arizona","8",818,580,1398,0.585121602288984,0.414878397711016
"762",2018,"Arizona","9",1546,715,2261,0.683768244139761,0.316231755860239
"763",2018,"Arkansas","2",3359,3621,6980,0.481232091690544,0.518767908309456
"764",2018,"California","1",524,0,524,1,0
"765",2018,"California","10",10986,7217,18203,0.603526891171785,0.396473108828215
"766",2018,"California","16",1398,940,2338,0.597946963216424,0.402053036783576
"767",2018,"California","20",595,0,595,1,0
"768",2018,"California","21",9705,6091,15796,0.614396049632818,0.385603950367182
"769",2018,"California","22",6425,3250,9675,0.664082687338501,0.335917312661499
"770",2018,"California","24",3088,1780,4868,0.634346754313887,0.365653245686113
"771",2018,"California","25",5817,689,6506,0.894097755917615,0.105902244082385
"772",2018,"California","36",1322,642,1964,0.673116089613035,0.326883910386965
"773",2018,"California","39",1248,617,1865,0.66916890080429,0.33083109919571
"774",2018,"California","4",1696,68,1764,0.961451247165533,0.0385487528344671
"775",2018,"California","45",2232,771,3003,0.743256743256743,0.256743256743257
"776",2018,"California","48",4980,11,4991,0.997796032859146,0.00220396714085354
"777",2018,"California","49",4007,164,4171,0.960680891872453,0.0393191081275474
"778",2018,"California","50",2777,34,2811,0.987904660263252,0.0120953397367485
"779",2018,"California","52",832,0,832,1,0
"780",2018,"California","7",343,0,343,1,0
"781",2018,"Colorado","3",3481,2550,6031,0.5771845465097,0.4228154534903
"782",2018,"Colorado","5",345,0,345,1,0
"783",2018,"Colorado","6",9982,3988,13970,0.714531138153185,0.285468861846815
"784",2018,"Connecticut","5",823,0,823,1,0
"785",2018,"Florida","12",13,0,13,1,0
"786",2018,"Florida","13",1,0,1,1,0
"787",2018,"Florida","15",1633,456,2089,0.781713738630924,0.218286261369076
"788",2018,"Florida","16",1964,2660,4624,0.424740484429066,0.575259515570934
"789",2018,"Florida","18",5676,3353,9029,0.628641045519991,0.371358954480009
"790",2018,"Florida","19",142,298,440,0.322727272727273,0.677272727272727
"791",2018,"Florida","25",1458,1359,2817,0.517571884984026,0.482428115015974
"792",2018,"Florida","26",7421,4168,11589,0.640348606437139,0.359651393562861
"793",2018,"Florida","27",1879,1180,3059,0.614253023864008,0.385746976135992
"794",2018,"Florida","3",13,0,13,1,0
"795",2018,"Florida","6",2964,886,3850,0.76987012987013,0.23012987012987
"796",2018,"Florida","7",1131,247,1378,0.820754716981132,0.179245283018868
"797",2018,"Georgia","10",2,0,2,1,0
"798",2018,"Georgia","12",6,769,775,0.00774193548387097,0.992258064516129
"799",2018,"Georgia","2",553,0,553,1,0
"800",2018,"Georgia","6",3414,1100,4514,0.75631369073992,0.24368630926008
"801",2018,"Georgia","7",2203,0,2203,1,0
"802",2018,"Hawaii","1",50,38,88,0.568181818181818,0.431818181818182
"803",2018,"Illinois","10",917,0,917,1,0
"804",2018,"Illinois","12",6995,4269,11264,0.621004971590909,0.378995028409091
"805",2018,"Illinois","13",8174,4473,12647,0.646319285205978,0.353680714794022
"806",2018,"Illinois","14",4816,417,5233,0.920313395757692,0.0796866042423084
"807",2018,"Illinois","17",1415,0,1415,1,0
"808",2018,"Illinois","18",13,0,13,1,0
"809",2018,"Illinois","6",5609,2802,8411,0.66686481987873,0.33313518012127
"810",2018,"Illinois","8",476,0,476,1,0
"811",2018,"Indiana","2",4324,4528,8852,0.488477180298238,0.511522819701762
"812",2018,"Indiana","3",1132,858,1990,0.568844221105528,0.431155778894472
"813",2018,"Indiana","5",18,229,247,0.0728744939271255,0.927125506072874
"814",2018,"Indiana","7",336,0,336,1,0
"815",2018,"Indiana","9",2683,1453,4136,0.648694390715667,0.351305609284333
"816",2018,"Iowa","1",9506,3438,12944,0.734394313967862,0.265605686032138
"817",2018,"Iowa","2",2459,0,2459,1,0
"818",2018,"Iowa","3",12291,6973,19264,0.638029485049834,0.361970514950166
"819",2018,"Iowa","4",2222,321,2543,0.873771136453008,0.126228863546992
"820",2018,"Kansas","1",93,0,93,1,0
"821",2018,"Kansas","2",11501,6641,18142,0.633943335905633,0.366056664094367
"822",2018,"Kansas","3",7718,6288,14006,0.551049550192775,0.448950449807225
"823",2018,"Kansas","4",235,757,992,0.236895161290323,0.763104838709677
"824",2018,"Kentucky","3",571,675,1246,0.458266452648475,0.541733547351525
"825",2018,"Kentucky","6",9997,13104,23101,0.432751828925155,0.567248171074845
"826",2018,"Louisiana","2",41,0,41,1,0
"827",2018,"Louisiana","3",225,76,301,0.747508305647841,0.252491694352159
"828",2018,"Maine","1",679,117,796,0.853015075376884,0.146984924623116
"829",2018,"Maine","2",17037,16548,33585,0.507280035730237,0.492719964269763
"830",2018,"Maryland","1",947,0,947,1,0
"831",2018,"Maryland","2",25,0,25,1,0
"832",2018,"Maryland","6",1516,0,1516,1,0
"833",2018,"Massachusetts","3",783,0,783,1,0
"834",2018,"Michigan","11",3983,662,4645,0.857481162540366,0.142518837459634
"835",2018,"Michigan","2",1633,357,1990,0.820603015075377,0.179396984924623
"836",2018,"Michigan","6",3579,4168,7747,0.461985284626307,0.538014715373693
"837",2018,"Michigan","7",3275,1187,4462,0.733975795607351,0.266024204392649
"838",2018,"Michigan","8",12755,3718,16473,0.774297335033084,0.225702664966916
"839",2018,"Minnesota","1",4614,4918,9532,0.484053713806127,0.515946286193873
"840",2018,"Minnesota","2",5921,3954,9875,0.599594936708861,0.400405063291139
"841",2018,"Minnesota","3",8893,6582,15475,0.574668820678514,0.425331179321486
"842",2018,"Minnesota","7",2136,0,2136,1,0
"843",2018,"Minnesota","8",5481,6522,12003,0.45663584103974,0.54336415896026
"844",2018,"Missouri","2",1674,919,2593,0.645584265329734,0.354415734670266
"845",2018,"Montana","1",12360,10394,22754,0.543201195394216,0.456798804605784
"846",2018,"Nebraska","2",2132,5022,7154,0.298015096449539,0.701984903550461
"847",2018,"Nevada","2",113,0,113,1,0
"848",2018,"Nevada","3",5653,2345,7998,0.706801700425106,0.293198299574894
"849",2018,"Nevada","4",4652,1911,6563,0.708822184976383,0.291177815023617
"850",2018,"New Hampshire","1",1275,322,1597,0.798371947401378,0.201628052598622
"851",2018,"New Hampshire","2",1140,0,1140,1,0
"852",2018,"New Jersey","11",3032,8,3040,0.997368421052632,0.00263157894736842
"853",2018,"New Jersey","2",810,0,810,1,0
"854",2018,"New Jersey","3",5353,3725,9078,0.589667327605199,0.410332672394801
"855",2018,"New Jersey","5",222,0,222,1,0
"856",2018,"New Jersey","7",913,791,1704,0.535798122065728,0.464201877934272
"857",2018,"New Mexico","1",1602,44,1646,0.973268529769137,0.0267314702308627
"858",2018,"New Mexico","2",17066,5778,22844,0.747067063561548,0.252932936438452
"859",2018,"New York","11",340,0,340,1,0
"860",2018,"New York","19",15039,8195,23234,0.647284152535078,0.352715847464922
"861",2018,"New York","20",110,0,110,1,0
"862",2018,"New York","21",2044,3264,5308,0.385079125847777,0.614920874152223
"863",2018,"New York","22",23880,18342,42222,0.56558192411539,0.43441807588461
"864",2018,"New York","23",2125,2245,4370,0.486270022883295,0.513729977116705
"865",2018,"New York","24",8002,5786,13788,0.580359733101247,0.419640266898753
"866",2018,"New York","25",1736,1061,2797,0.62066499821237,0.37933500178763
"867",2018,"New York","26",14,0,14,1,0
"868",2018,"New York","27",974,1211,2185,0.445766590389016,0.554233409610984
"869",2018,"New York","4",20,0,20,1,0
"870",2018,"New York",NA,181,0,181,1,0
"871",2018,"North Carolina","11",248,0,248,1,0
"872",2018,"North Carolina","13",7433,4334,11767,0.631681822044701,0.368318177955299
"873",2018,"North Carolina","2",3126,3120,6246,0.500480307396734,0.499519692603266
"874",2018,"North Carolina","5",26,1236,1262,0.0206022187004754,0.979397781299525
"875",2018,"North Carolina","7",964,538,1502,0.641810918774967,0.358189081225033
"876",2018,"North Carolina","9",13783,3005,16788,0.82100309745056,0.17899690254944
"877",2018,"North Dakota","1",1240,1400,2640,0.46969696969697,0.53030303030303
"878",2018,"Ohio","1",7455,6142,13597,0.548282709421196,0.451717290578804
"879",2018,"Ohio","10",1630,819,2449,0.665577786851776,0.334422213148224
"880",2018,"Ohio","12",1729,1560,3289,0.525691699604743,0.474308300395257
"881",2018,"Ohio","13",23,0,23,1,0
"882",2018,"Ohio","14",2104,884,2988,0.704149933065596,0.295850066934404
"883",2018,"Ohio","15",306,599,905,0.338121546961326,0.661878453038674
"884",2018,"Ohio","16",13,198,211,0.0616113744075829,0.938388625592417
"885",2018,"Ohio","3",254,0,254,1,0
"886",2018,"Ohio","4",972,1073,2045,0.475305623471883,0.524694376528117
"887",2018,"Ohio","7",2137,879,3016,0.708554376657825,0.291445623342175
"888",2018,"Oklahoma","1",149,248,397,0.375314861460957,0.624685138539043
"889",2018,"Oklahoma","5",1803,724,2527,0.713494261970716,0.286505738029284
"890",2018,"Oregon","2",1109,1803,2912,0.380837912087912,0.619162087912088
"891",2018,"Oregon","5",296,0,296,1,0
"892",2018,"Pennsylvania","1",5308,4347,9655,0.549766960124288,0.450233039875712
"893",2018,"Pennsylvania","10",3811,2685,6496,0.586668719211823,0.413331280788177
"894",2018,"Pennsylvania","11",235,1060,1295,0.181467181467181,0.818532818532819
"895",2018,"Pennsylvania","12",1,0,1,1,0
"896",2018,"Pennsylvania","14",132,425,557,0.236983842010772,0.763016157989228
"897",2018,"Pennsylvania","16",4714,4215,8929,0.52794265875238,0.47205734124762
"898",2018,"Pennsylvania","17",2188,1865,4053,0.539847026893659,0.460152973106341
"899",2018,"Pennsylvania","4",204,0,204,1,0
"900",2018,"Pennsylvania","5",268,0,268,1,0
"901",2018,"Pennsylvania","6",1346,0,1346,1,0
"902",2018,"Pennsylvania","7",2477,0,2477,1,0
"903",2018,"Pennsylvania","8",4210,4992,9202,0.457509237122365,0.542490762877635
"904",2018,"Pennsylvania","9",1228,1055,2283,0.537888742882173,0.462111257117827
"905",2018,"South Carolina","1",3533,2220,5753,0.614114375108639,0.385885624891361
"906",2018,"South Dakota","1",1212,1048,2260,0.536283185840708,0.463716814159292
"907",2018,"Tennessee","2",500,254,754,0.663129973474801,0.336870026525199
"908",2018,"Tennessee","3",129,174,303,0.425742574257426,0.574257425742574
"909",2018,"Texas","1",3,0,3,1,0
"910",2018,"Texas","15",431,0,431,1,0
"911",2018,"Texas","17",23,666,689,0.0333817126269956,0.966618287373004
"912",2018,"Texas","2",285,517,802,0.355361596009975,0.644638403990025
"913",2018,"Texas","21",1457,299,1756,0.829726651480638,0.170273348519362
"914",2018,"Texas","22",97,0,97,1,0
"915",2018,"Texas","23",9318,7672,16990,0.548440258975868,0.451559741024132
"916",2018,"Texas","25",38,541,579,0.0656303972366149,0.934369602763385
"917",2018,"Texas","27",12,0,12,1,0
"918",2018,"Texas","31",8424,1088,9512,0.885618166526493,0.114381833473507
"919",2018,"Texas","32",4539,3206,7745,0.586055519690123,0.413944480309877
"920",2018,"Texas","34",255,29,284,0.897887323943662,0.102112676056338
"921",2018,"Texas","7",8716,4995,13711,0.635693968346583,0.364306031653417
"922",2018,"Texas","9",138,0,138,1,0
"923",2018,"Utah","4",6689,4626,11315,0.59116217410517,0.40883782589483
"924",2018,"Virginia","10",6602,3336,9938,0.664318776413765,0.335681223586235
"925",2018,"Virginia","2",15965,6305,22270,0.716883700044903,0.283116299955097
"926",2018,"Virginia","5",5492,6205,11697,0.46952209968368,0.53047790031632
"927",2018,"Virginia","6",724,714,1438,0.503477051460362,0.496522948539638
"928",2018,"Virginia","7",9404,4901,14305,0.657392520097868,0.342607479902132
"929",2018,"Virginia","9",1378,1176,2554,0.539545810493344,0.460454189506656
"930",2018,"Washington","3",6208,2920,9128,0.680105170902717,0.319894829097283
"931",2018,"Washington","5",5778,6011,11789,0.49011790652303,0.50988209347697
"932",2018,"Washington","8",10772,6337,17109,0.629610146706412,0.370389853293588
"933",2018,"Washington","9",749,0,749,1,0
"934",2018,"West Virginia","2",446,743,1189,0.375105130361648,0.624894869638352
"935",2018,"West Virginia","3",7271,2983,10254,0.709089135946948,0.290910864053052
"936",2018,"Wisconsin","1",2726,3010,5736,0.475244072524407,0.524755927475593
"937",2018,"Wisconsin","6",8554,1943,10497,0.814899495093836,0.185100504906164
"938",2018,"Wisconsin","8",302,1911,2213,0.13646633529146,0.86353366470854
"939",2006,"Alabama","5",0,55,55,0,1
"940",2006,"California","45",0,10,10,0,1
"941",2006,"California","52",0,47,47,0,1
"942",2006,"Colorado","6",0,424,424,0,1
"943",2006,"Connecticut",NA,0,3,3,0,1
"944",2006,"Florida","14",0,113,113,0,1
"945",2006,"Florida","18",0,34,34,0,1
"946",2006,"Florida","21",0,65,65,0,1
"947",2006,"Florida","24",0,241,241,0,1
"948",2006,"Florida","4",0,155,155,0,1
"949",2006,"Georgia","1",0,208,208,0,1
"950",2006,"Illinois","14",0,13,13,0,1
"951",2006,"Illinois","15",0,87,87,0,1
"952",2006,"Illinois","18",0,78,78,0,1
"953",2006,"Indiana","5",0,33,33,0,1
"954",2006,"Indiana","6",0,185,185,0,1
"955",2006,"Kansas","4",0,945,945,0,1
"956",2006,"Kentucky","5",0,330,330,0,1
"957",2006,"Louisiana","4",0,244,244,0,1
"958",2006,"Minnesota","7",0,57,57,0,1
"959",2006,"Missouri","2",0,130,130,0,1
"960",2006,"Missouri","6",0,398,398,0,1
"961",2006,"Missouri","7",0,899,899,0,1
"962",2006,"Nebraska","2",0,184,184,0,1
"963",2006,"New Jersey","8",0,31,31,0,1
"964",2006,"New York","23",0,776,776,0,1
"965",2006,"North Carolina","12",0,9,9,0,1
"966",2006,"North Carolina","5",0,137,137,0,1
"967",2006,"North Carolina","9",0,80,80,0,1
"968",2006,"Ohio","14",0,152,152,0,1
"969",2006,"Ohio","4",0,2333,2333,0,1
"970",2006,"Oklahoma","1",0,236,236,0,1
"971",2006,"Oklahoma","3",0,18,18,0,1
"972",2006,"Oklahoma","4",0,152,152,0,1
"973",2006,"Oregon","2",0,375,375,0,1
"974",2006,"Tennessee","1",0,2657,2657,0,1
"975",2006,"Tennessee","3",0,720,720,0,1
"976",2006,"Texas","14",0,76,76,0,1
"977",2006,"Virginia","7",0,324,324,0,1
"978",2006,"Wisconsin","5",0,17,17,0,1
"979",2010,"Alabama","1",0,236,236,0,1
"980",2010,"Alabama","6",0,63,63,0,1
"981",2010,"Arizona","2",0,26,26,0,1
"982",2010,"California","19",0,313,313,0,1
"983",2010,"California","21",0,217,217,0,1
"984",2010,"California","42",0,17,17,0,1
"985",2010,"Colorado","1",0,13,13,0,1
"986",2010,"Colorado","2",0,4,4,0,1
"987",2010,"Connecticut","3",0,137,137,0,1
"988",2010,"District of Columbia","1",0,75,75,0,1
"989",2010,"Florida","10",0,227,227,0,1
"990",2010,"Florida","16",0,188,188,0,1
"991",2010,"Florida","18",0,114,114,0,1
"992",2010,"Florida","7",0,412,412,0,1
"993",2010,"Georgia","5",0,4,4,0,1
"994",2010,"Georgia","9",0,1344,1344,0,1
"995",2010,"Illinois","15",0,4,4,0,1
"996",2010,"Illinois","2",0,15,15,0,1
"997",2010,"Illinois","9",0,43,43,0,1
"998",2010,"Indiana","4",0,1243,1243,0,1
"999",2010,"Indiana","5",0,1546,1546,0,1
"1000",2010,"Indiana","6",0,426,426,0,1
"1001",2010,"Iowa","4",0,266,266,0,1
"1002",2010,"Iowa","5",0,179,179,0,1
"1003",2010,"Kansas","2",0,465,465,0,1
"1004",2010,"Kentucky","2",0,446,446,0,1
"1005",2010,"Maryland","5",0,16,16,0,1
"1006",2010,"Michigan","2",0,581,581,0,1
"1007",2010,"Michigan","6",0,400,400,0,1
"1008",2010,"Minnesota","3",0,1705,1705,0,1
"1009",2010,"Mississippi","3",0,378,378,0,1
"1010",2010,"Missouri","5",0,165,165,0,1
"1011",2010,"New Jersey","12",0,145,145,0,1
"1012",2010,"North Carolina","10",0,90,90,0,1
"1013",2010,"North Carolina","3",0,6,6,0,1
"1014",2010,"North Carolina","5",0,82,82,0,1
"1015",2010,"North Carolina","6",0,39,39,0,1
"1016",2010,"North Carolina","9",0,26,26,0,1
"1017",2010,"Oklahoma","1",0,253,253,0,1
"1018",2010,"Oregon","2",0,441,441,0,1
"1019",2010,"South Carolina","4",0,1957,1957,0,1
"1020",2010,"Tennessee","2",0,36,36,0,1
"1021",2010,"Texas","15",0,55,55,0,1
"1022",2010,"Texas","30",0,71,71,0,1
"1023",2010,"Texas","4",0,83,83,0,1
"1024",2010,"Wisconsin","2",0,50,50,0,1
"1025",2012,"Alabama","01",0,1485,1485,0,1
"1026",2012,"Alabama","04",0,194,194,0,1
"1027",2012,"Alabama","05",0,292,292,0,1
"1028",2012,"Alaska","01",0,395,395,0,1
"1029",2012,"Arizona","04",0,574,574,0,1
"1030",2012,"Arizona","05",0,128,128,0,1
"1031",2012,"Arizona","06",0,2159,2159,0,1
"1032",2012,"California","11",0,1,1,0,1
"1033",2012,"California","17",0,22,22,0,1
"1034",2012,"California","19",0,1190,1190,0,1
"1035",2012,"California","23",0,231,231,0,1
"1036",2012,"California","38",0,1,1,0,1
"1037",2012,"Colorado","05",0,2061,2061,0,1
"1038",2012,"Florida","03",0,1425,1425,0,1
"1039",2012,"Florida","06",0,8,8,0,1
"1040",2012,"Florida","07",0,964,964,0,1
"1041",2012,"Florida","12",0,57,57,0,1
"1042",2012,"Florida","14",0,43,43,0,1
"1043",2012,"Florida","27",0,53,53,0,1
"1044",2012,"Illinois","18",0,1205,1205,0,1
"1045",2012,"Indiana","03",0,367,367,0,1
"1046",2012,"Indiana","05",0,1395,1395,0,1
"1047",2012,"Indiana","06",0,601,601,0,1
"1048",2012,"Kansas","01",0,486,486,0,1
"1049",2012,"Kansas","02",0,897,897,0,1
"1050",2012,"Kentucky","04",0,1292,1292,0,1
"1051",2012,"Kentucky","05",0,343,343,0,1
"1052",2012,"Maryland","01",0,325,325,0,1
"1053",2012,"Michigan","04",0,1804,1804,0,1
"1054",2012,"Michigan","07",0,340,340,0,1
"1055",2012,"Michigan","08",0,348,348,0,1
"1056",2012,"Michigan","09",0,23,23,0,1
"1057",2012,"Minnesota","05",0,2,2,0,1
"1058",2012,"Mississippi","01",0,1466,1466,0,1
"1059",2012,"Missouri","07",0,335,335,0,1
"1060",2012,"Missouri","08",0,278,278,0,1
"1061",2012,"New Mexico","02",0,279,279,0,1
"1062",2012,"New Mexico","03",0,29,29,0,1
"1063",2012,"North Carolina","02",0,149,149,0,1
"1064",2012,"North Carolina","03",0,48,48,0,1
"1065",2012,"North Carolina","04",0,70,70,0,1
"1066",2012,"North Carolina","06",0,1,1,0,1
"1067",2012,"North Carolina","13",0,639,639,0,1
"1068",2012,"Ohio","01",0,245,245,0,1
"1069",2012,"Ohio","02",0,208,208,0,1
"1070",2012,"Ohio","08",0,8,8,0,1
"1071",2012,"Ohio","12",0,560,560,0,1
"1072",2012,"Ohio","15",0,1024,1024,0,1
"1073",2012,"Oklahoma","03",0,906,906,0,1
"1074",2012,"Oklahoma","04",0,199,199,0,1
"1075",2012,"Oregon","02",0,2123,2123,0,1
"1076",2012,"Pennsylvania","04",0,505,505,0,1
"1077",2012,"Pennsylvania","05",0,218,218,0,1
"1078",2012,"Pennsylvania","08",0,747,747,0,1
"1079",2012,"Pennsylvania","15",0,116,116,0,1
"1080",2012,"Pennsylvania","16",0,116,116,0,1
"1081",2012,"South Carolina","01",0,392,392,0,1
"1082",2012,"South Carolina","07",0,233,233,0,1
"1083",2012,"Tennessee","06",0,1988,1988,0,1
"1084",2012,"Texas","24",0,2,2,0,1
"1085",2012,"Texas","25",0,1659,1659,0,1
"1086",2012,"Virginia","04",0,232,232,0,1
"1087",2012,"Virginia","06",0,138,138,0,1
"1088",2012,"Washington","03",0,979,979,0,1
"1089",2014,"Alaska","1",0,210,210,0,1
"1090",2014,"California","22",0,359,359,0,1
"1091",2014,"California","23",0,1131,1131,0,1
"1092",2014,"Colorado","3",0,748,748,0,1
"1093",2014,"Florida","16",0,25,25,0,1
"1094",2014,"Georgia","1",0,790,790,0,1
"1095",2014,"Indiana","8",0,113,113,0,1
"1096",2014,"Kansas","2",0,3806,3806,0,1
"1097",2014,"Kansas","4",0,239,239,0,1
"1098",2014,"Louisiana","1",0,408,408,0,1
"1099",2014,"Louisiana","3",0,333,333,0,1
"1100",2014,"Louisiana","5",0,15,15,0,1
"1101",2014,"Louisiana","6",0,788,788,0,1
"1102",2014,"Michigan","4",0,598,598,0,1
"1103",2014,"Minnesota","3",0,637,637,0,1
"1104",2014,"Missouri","7",0,664,664,0,1
"1105",2014,"New Jersey","2",0,518,518,0,1
"1106",2014,"New Jersey","5",0,31,31,0,1
"1107",2014,"North Carolina","1",0,4,4,0,1
"1108",2014,"Ohio","12",0,190,190,0,1
"1109",2014,"Ohio","15",0,123,123,0,1
"1110",2014,"Ohio","5",0,290,290,0,1
"1111",2014,"Ohio","8",0,1716,1716,0,1
"1112",2014,"Oklahoma","4",0,432,432,0,1
"1113",2014,"Oregon","2",0,840,840,0,1
"1114",2014,"Pennsylvania","3",0,546,546,0,1
"1115",2014,"Pennsylvania","8",0,377,377,0,1
"1116",2014,"South Carolina","5",0,164,164,0,1
"1117",2014,"South Dakota","1",0,426,426,0,1
"1118",2014,"Tennessee","2",0,70,70,0,1
"1119",2014,"Virginia","11",0,10,10,0,1
"1120",2014,"Washington","4",0,160,160,0,1
"1121",2014,"Washington","8",0,188,188,0,1
"1122",2014,"West Virginia","1",0,5,5,0,1
"1123",2014,"Wisconsin","1",0,2186,2186,0,1
"1124",2016,"Alabama","2",0,518,518,0,1
"1125",2016,"California","33",0,9,9,0,1
"1126",2016,"California","53",0,3,3,0,1
"1127",2016,"Florida","12",0,45,45,0,1
"1128",2016,"Florida","25",0,238,238,0,1
"1129",2016,"Florida","6",0,411,411,0,1
"1130",2016,"Illinois","13",0,362,362,0,1
"1131",2016,"Illinois","6",0,1,1,0,1
"1132",2016,"Indiana","3",0,169,169,0,1
"1133",2016,"Kansas","1",0,475,475,0,1
"1134",2016,"Kansas","2",0,479,479,0,1
"1135",2016,"Kentucky","1",0,320,320,0,1
"1136",2016,"Louisiana","1",0,510,510,0,1
"1137",2016,"Louisiana","3",0,1175,1175,0,1
"1138",2016,"Louisiana","6",0,523,523,0,1
"1139",2016,"Maine","1",0,101,101,0,1
"1140",2016,"Michigan","1",0,315,315,0,1
"1141",2016,"Missouri","4",0,125,125,0,1
"1142",2016,"New Jersey","2",0,483,483,0,1
"1143",2016,"New Jersey","3",0,688,688,0,1
"1144",2016,"New Jersey","9",0,23,23,0,1
"1145",2016,"North Carolina","13",0,408,408,0,1
"1146",2016,"North Carolina","2",0,297,297,0,1
"1147",2016,"Ohio","10",0,315,315,0,1
"1148",2016,"Ohio","15",0,590,590,0,1
"1149",2016,"Oklahoma","5",0,130,130,0,1
"1150",2016,"Pennsylvania","12",0,733,733,0,1
"1151",2016,"Pennsylvania","15",0,116,116,0,1
"1152",2016,"Pennsylvania","9",0,652,652,0,1
"1153",2016,"South Carolina","4",0,192,192,0,1
"1154",2016,"Tennessee","8",0,407,407,0,1
"1155",2016,"Texas","33",0,6,6,0,1
"1156",2016,"Texas","8",0,4,4,0,1
"1157",2016,"Virginia","2",0,68,68,0,1
"1158",2016,"Washington","3",0,752,752,0,1
"1159",2016,"Washington","4",0,446,446,0,1
"1160",2016,"Washington","8",0,328,328,0,1
"1161",2016,"Wisconsin","1",0,992,992,0,1
"1162",2016,"Wisconsin","6",0,576,576,0,1
"1163",2018,"Alabama","3",0,1071,1071,0,1
"1164",2018,"Alabama","4",0,397,397,0,1
"1165",2018,"Alabama","6",0,593,593,0,1
"1166",2018,"Alaska","1",0,1451,1451,0,1
"1167",2018,"Arkansas","3",0,271,271,0,1
"1168",2018,"Arkansas","4",0,570,570,0,1
"1169",2018,"California","23",0,384,384,0,1
"1170",2018,"Florida","2",0,639,639,0,1
"1171",2018,"Idaho","1",0,289,289,0,1
"1172",2018,"Indiana","6",0,72,72,0,1
"1173",2018,"Kentucky","1",0,512,512,0,1
"1174",2018,"Louisiana","1",0,524,524,0,1
"1175",2018,"Louisiana","4",0,363,363,0,1
"1176",2018,"Louisiana","5",0,346,346,0,1
"1177",2018,"Louisiana","6",0,698,698,0,1
"1178",2018,"Michigan","4",0,740,740,0,1
"1179",2018,"Missouri","4",0,300,300,0,1
"1180",2018,"Missouri","6",0,540,540,0,1
"1181",2018,"Missouri","8",0,109,109,0,1
"1182",2018,"Nebraska","1",0,762,762,0,1
"1183",2018,"New Jersey","1",0,1,1,0,1
"1184",2018,"New York","2",0,147,147,0,1
"1185",2018,"North Carolina","8",0,427,427,0,1
"1186",2018,"Ohio","2",0,765,765,0,1
"1187",2018,"Ohio","5",0,417,417,0,1
"1188",2018,"Oklahoma","2",0,522,522,0,1
"1189",2018,"Oklahoma","4",0,272,272,0,1
"1190",2018,"Pennsylvania","13",0,47,47,0,1
"1191",2018,"Pennsylvania","15",0,191,191,0,1
"1192",2018,"South Carolina","5",0,208,208,0,1
"1193",2018,"South Carolina","7",0,387,387,0,1
"1194",2018,"Tennessee","1",0,264,264,0,1
"1195",2018,"Tennessee","7",0,212,212,0,1
"1196",2018,"Tennessee","8",0,272,272,0,1
"1197",2018,"Texas","16",0,138,138,0,1
"1198",2018,"Texas","3",0,855,855,0,1
"1199",2018,"Texas","36",0,115,115,0,1
"1200",2018,"Vermont","1",0,5,5,0,1
"1201",2018,"Virginia","1",0,307,307,0,1
"1202",2018,"Virginia","11",0,11,11,0,1
"1203",2018,"Washington","6",0,3,3,0,1
